1111111111111111111111111111111111
1ET000000000000C00000C000000000001
101001010010000010100100T00T010101
10100100101010100010010000000101T1
1P0000000C00C0000000000000000000C1
1111111111111111111111111111111111
