1111111
1000001
1111111
1111111
1000001
1111111
1111111
1TTTTT1
1111111
1111111
1P0C0E1
1111111
