111111111111111111111111111111111111111111111111111
10000000000000000000C000000000000000000000000001111
100000000000000000C0PC00000000000000000000000000001
10000000000000000000C000000000000000000000000000001
100000000000000000000000000000000000000000000000001
100000000000000000000000000000000000000000000000001
100000000000000000111000000000000000000011100000001
10000000000000000010100000000000000000001E100000001
100000000000000000111000000000000000000011100000001
111111111111111111111111111111111111111111111111111
111111111111111111111111111111111111111111111111111
111111111111111111111111111111111111111111111111111
111111111111111111111111111111111111111111111111111
111111111111111111111111111111111111111111111111111
111111111111111111111111111111111111111111111111111
111111111111111111111111111111111111111111111111111
111111111111111111111111111111111111111111111111111
