11111111111111111111111
1TTTTTTTTTTTTTTTTTTTTT1
1PCCCCCCCCCCCCCCCCCCCE1
1TTTTTTTTTTTTTTTTTTTTT1
11111111111111111111111
