1111111111111111111111
1CCCCCCCCCCCCCCCCCCCP1
1011111111111111111111
101C0000000000000000C1
1010111111111111111101
10101E000000000000C101
1010111111111111110101
101C00000000000000C101
1011111111111111111101
1CCCCCCCCCCCCCCCCCCCC1
1111111111111111111111
